Immersive Labs	sales@immersivelabs.com
Kyruus	info@kyruus.com
Vicarious Surgical	info@vicarioussurgical.com
Asimov	hello@asimov.com
Rapid7	sales@rapid7.com
SmartBear	info@smartbear.com
BlueConic	info@blueconic.com
OneView Commerce	info@oneviewcommerce.com
Acquia	info@acquia.com
InterSystems	support@intersystems.com
MassMutual	brand@massmutual.com
Skillsoft	info@skillsoft.com
Network For Good	partnerships@networkforgood.com
CyberGrants	hello@cybergrants.com
Bullhorn	sales@bullhorn.com
Atlassian	info@atlassian.com
Pluralsight	support@pluralsight.com
RSM	administration@rsmacton.com
Infinite Analytics	contactus@infiniteanalytics.com
NuVu Studio	nuvu@nuvustudio.org
SmartKargo	cambridge@smartkargo.com
Givebutter	support@givebutter.com
Virtual	info@virtualinc.com
Wildbit	hello@wildbit.com
RStudio	INFO@POSIT.CO
AgIntegrated	info@agintegrated.com
Think Company	info@thinkcompany.com